100000000000000000010000000000
100000000000000000010000000000
100000000000000000010000000000
100000000000000000010000000000
100000022222000000010000000000
100000000000000000010000000000
122000000000000002210000022000
111222222222222221110002211200
111111111111111111110001111100
111111111111111111110000110000
111111111111111111110000100000
111111111111111111110000100000
111111111111111111110000000000